25 25 25 25 25 25 25 25 25 25 25 25 25 25 25 25 25 25 25 25 25 25 25 25 25 25 25 25 25 25 25 25 25 25 25 25 25 25 25 25 25 25 25 25 25 25 25 25 25 25 
25 25 25 25 25 25 25 25 25 25 25 25 25 25 25 25 25 25 25 25 25 25 25 25 25 25 25 25 25 25 25 25 25 25 25 25 25 25 25 25 25 25 25 25 25 25 25 25 25 25 
25 25 25 25 25 25 25 25 25 25 25 25 25 25 25 25 25 25 25 25 25 25 25 25 25 25 25 25 25 25 25 25 25 25 25 25 25 25 25 25 25 25 25 25 25 25 25 25 25 25 
25 25 25 25 25 25 25 25 25 25 25 25 25 25 25 25 25 25 25 24 24 24 24 24 24 24 24 24 25 25 25 25 25 25 25 25 25 25 25 25 25 25 25 25 25 25 25 25 25 25 
25 25 25 25 25 25 25 25 25 25 25 25 24 24 24 24 24 24 24 24 24 24 24 24 24 24 24 24 24 24 24 25 25 25 25 25 25 25 25 25 25 25 25 25 25 25 25 25 25 25 
25 25 25 25 25 25 25 25 24 24 24 34 32 32 32 32 32 32 32 32 32 32 32 32 32 32 32 32 32 32 32 32 32 35 25 25 25 25 25 25 25 25 25 25 25 25 25 25 25 25 
25 25 25 25 25 25 24 24 24 24 34 33 4 4 4 4 4 4 4 4 4 4 4 4 4 4 4 4 4 4 4 4 4 31 32 32 32 32 32 32 35 24 25 25 25 25 25 25 25 25 
25 25 25 25 25 24 24 24 24 34 33 4 4 4 4 4 4 4 4 4 4 4 4 4 4 4 4 4 4 4 4 4 4 4 4 4 4 4 4 4 31 32 35 25 25 25 25 25 25 25 
25 25 25 25 25 24 24 24 34 33 4 4 4 4 4 4 4 4 4 4 4 4 4 4 4 4 4 4 4 4 4 4 4 4 4 4 4 4 4 4 4 4 29 25 25 25 25 25 25 25 
25 25 25 25 25 34 32 32 33 4 4 4 4 4 4 4 4 4 4 4 4 4 4 4 4 4 4 4 4 4 4 4 4 4 4 4 4 4 4 4 4 4 29 25 25 25 25 25 25 25 
25 25 25 25 25 30 4 4 4 4 4 4 4 4 4 4 4 4 4 4 4 4 4 4 4 4 4 4 4 4 4 4 4 4 4 4 4 4 4 4 4 4 29 25 25 25 25 25 25 25 
25 25 25 25 24 30 4 4 4 4 4 4 4 4 4 4 4 4 4 4 4 4 4 4 4 4 4 4 4 4 4 4 4 4 4 4 4 4 4 4 4 4 29 25 25 25 25 25 25 25 
25 25 25 25 24 30 4 4 4 4 4 4 4 4 4 4 4 4 4 4 4 4 4 4 4 4 4 4 4 4 4 4 4 4 4 4 4 4 4 4 4 4 31 35 25 25 25 25 25 25 
25 25 25 25 24 30 4 4 4 4 4 4 4 4 4 4 4 4 4 4 4 4 4 4 4 4 4 4 4 4 4 4 4 4 4 4 4 4 4 4 4 4 4 29 25 25 25 25 25 25 
25 25 25 25 24 30 4 4 4 4 4 4 4 4 4 4 4 4 4 4 4 4 4 4 4 4 4 4 4 4 4 4 4 4 4 4 4 4 4 4 4 4 4 29 25 25 25 25 25 25 
25 25 25 25 24 30 4 4 4 4 4 4 4 4 4 4 4 4 4 4 4 4 4 4 4 4 4 12 7 11 4 4 4 4 4 4 4 4 4 4 4 4 4 29 25 25 25 25 25 25 
25 25 25 25 24 30 4 4 4 4 4 4 4 4 4 4 4 4 4 4 4 4 4 4 4 4 4 12 7 11 4 4 4 4 4 4 4 4 4 4 4 4 4 29 25 25 25 25 25 25 
25 25 25 25 24 30 4 4 4 4 4 4 4 4 4 4 4 4 4 4 4 4 4 4 4 4 4 12 7 11 4 4 4 4 4 4 4 4 4 4 4 4 4 29 25 25 25 25 25 25 
25 25 25 25 24 30 4 4 4 4 4 4 4 4 4 4 4 4 4 4 4 4 4 4 4 4 4 12 7 11 4 4 4 4 4 4 4 4 4 4 4 4 4 29 25 25 25 25 25 25 
25 25 25 25 24 30 4 4 4 4 4 4 4 4 4 4 4 4 4 4 4 4 4 4 4 4 4 12 7 11 4 4 4 4 4 4 4 4 4 4 4 4 4 31 35 25 25 25 25 25 
25 25 25 25 24 30 4 4 4 4 4 4 4 4 4 4 4 4 4 4 4 4 23 4 4 4 4 12 7 11 4 4 4 6 4 4 4 4 4 4 4 4 4 4 29 25 25 25 25 25 
25 25 25 25 25 30 4 4 4 4 4 4 4 4 4 4 4 4 4 4 4 4 4 4 4 4 4 12 7 11 4 4 4 4 4 4 4 4 4 4 4 4 4 4 29 25 25 25 25 25 
25 25 25 25 25 30 4 4 4 4 4 4 4 4 4 4 4 4 4 4 4 4 4 4 4 4 4 12 7 11 4 4 4 4 4 4 4 4 4 4 4 4 4 4 29 25 25 25 25 25 
25 25 25 25 25 30 4 4 4 4 4 4 4 4 4 4 4 4 4 4 4 4 4 4 4 4 4 12 7 11 4 4 4 4 4 4 4 4 4 4 4 4 4 4 29 25 25 25 25 25 
25 25 25 25 25 30 14 14 14 14 14 14 14 14 14 14 14 14 14 14 14 14 14 14 14 14 14 15 7 13 14 14 14 14 14 14 14 14 14 14 14 14 14 14 29 25 25 25 25 25 
25 25 25 25 25 30 7 7 7 7 7 7 7 7 7 7 7 7 7 7 7 7 7 7 7 7 7 7 7 7 7 7 7 7 7 7 7 7 7 7 7 7 7 7 29 25 25 25 25 25 
25 25 25 25 25 30 9 9 9 9 9 9 9 9 9 9 9 9 9 9 9 9 9 9 9 9 9 10 7 8 9 9 9 9 9 9 9 9 9 9 9 9 9 9 29 25 25 25 25 25 
25 25 25 25 25 30 4 4 4 4 4 4 4 4 4 4 4 4 4 4 4 4 5 5 5 5 5 12 7 11 5 5 5 5 5 5 5 5 5 5 5 5 4 4 29 25 25 25 25 25 
25 25 25 25 25 30 4 4 4 4 4 4 4 4 4 4 4 4 4 4 4 4 5 5 5 5 5 12 7 11 5 5 5 5 5 5 5 5 5 5 5 5 4 4 29 25 25 25 25 25 
25 25 25 25 25 30 4 4 4 4 4 4 4 4 4 4 4 4 4 4 5 5 4 5 5 5 5 12 7 11 5 5 5 5 4 5 5 5 5 5 5 5 5 4 29 25 25 25 25 25 
25 25 25 25 25 30 4 4 4 4 4 4 4 4 4 4 4 4 4 4 5 5 5 5 5 5 5 12 7 11 5 5 5 5 5 5 5 5 5 5 5 5 5 5 29 25 25 25 25 25 
25 25 25 25 25 30 4 4 4 4 4 4 4 4 4 4 4 4 4 5 5 5 5 5 5 5 5 12 7 11 5 5 5 5 5 5 5 4 4 4 4 4 4 4 29 25 25 25 25 25 
25 25 25 25 25 30 4 4 4 4 4 4 4 4 4 4 4 4 4 5 4 5 5 5 4 5 5 12 7 11 5 4 4 4 4 4 5 4 4 4 4 4 4 4 29 25 25 25 25 25 
25 25 25 25 25 30 4 4 4 4 4 4 4 4 4 4 4 4 5 5 5 5 5 5 5 5 5 12 7 11 5 5 4 4 4 4 4 4 4 4 4 4 4 4 29 25 25 25 25 25 
25 25 25 25 25 30 4 4 4 4 4 4 4 4 4 4 4 4 5 4 5 5 5 5 5 5 5 12 7 11 5 5 4 4 4 4 4 4 4 4 4 4 4 4 29 24 25 25 25 25 
25 25 25 25 25 30 4 4 4 4 4 4 4 4 4 4 4 4 5 5 5 5 5 4 5 5 5 5 5 4 5 5 4 4 4 4 4 4 4 4 4 4 4 4 29 24 25 25 25 25 
25 25 25 25 25 30 4 4 4 4 4 4 4 4 4 4 4 4 5 5 5 5 4 5 5 5 5 5 5 5 4 4 4 4 4 4 4 4 4 4 4 4 4 4 29 24 25 25 25 25 
25 25 25 25 25 30 4 4 4 4 4 4 4 4 4 4 4 4 4 5 5 5 5 5 5 5 5 5 4 5 4 4 4 4 4 4 4 4 4 4 4 4 4 4 29 24 25 25 25 25 
25 25 25 25 25 30 4 4 4 4 4 4 4 4 4 4 4 4 4 5 5 5 5 5 5 4 5 4 4 5 4 4 4 4 4 4 4 4 4 4 4 4 4 4 29 24 24 25 25 25 
25 25 25 25 25 30 4 4 4 4 4 4 4 4 4 4 4 4 4 5 5 5 5 4 5 5 5 4 4 5 5 4 4 4 4 4 4 4 4 4 4 4 4 4 29 24 24 25 25 25 
25 25 25 25 25 30 4 4 4 4 4 4 4 4 4 4 4 4 4 4 4 4 4 4 4 4 4 4 4 5 5 4 4 4 4 4 4 4 4 4 4 4 4 4 29 24 24 25 25 25 
25 25 25 25 25 30 5 5 5 5 5 5 5 5 5 5 5 5 5 5 5 5 5 5 5 5 5 5 5 5 4 4 4 4 4 4 4 4 4 4 4 4 4 4 29 24 24 25 25 25 
25 25 25 25 25 36 28 28 5 5 5 5 5 5 5 5 5 5 5 5 5 5 5 5 5 5 5 5 5 5 4 4 4 4 4 4 4 4 4 4 4 4 4 26 24 24 24 25 25 25 
25 25 25 25 25 25 25 36 27 27 27 27 27 27 27 27 27 27 27 27 27 27 27 27 27 27 27 27 27 27 27 27 27 27 27 27 27 27 27 27 27 27 27 37 25 24 25 25 25 25 
25 25 25 25 25 25 24 24 24 24 24 24 24 24 24 24 24 24 24 24 24 24 24 24 24 24 24 24 24 24 24 24 24 24 24 24 24 24 24 24 24 24 24 24 24 24 25 25 25 25 
25 25 25 25 25 25 25 25 25 25 25 24 24 24 24 24 24 24 24 24 24 24 24 24 24 24 24 24 24 24 24 24 24 24 24 24 24 24 24 24 24 24 24 24 24 25 25 25 25 25 
25 25 25 25 25 25 25 25 25 25 25 25 25 25 25 25 25 25 25 24 24 24 24 24 24 24 24 24 24 24 24 24 24 24 24 24 24 24 24 24 24 24 24 24 25 25 25 25 25 25 
25 25 25 25 25 25 25 25 25 25 25 25 25 25 25 25 25 25 24 24 24 24 24 24 24 24 24 24 24 24 24 24 24 24 24 24 24 24 24 24 24 24 24 24 24 24 25 25 25 25 
25 25 25 25 25 25 25 25 25 25 25 25 25 25 25 25 25 25 25 25 25 25 25 25 25 25 25 25 25 24 24 24 24 24 24 24 24 24 24 24 24 24 24 24 25 25 25 25 25 25 
25 25 25 25 25 25 25 25 25 25 25 25 25 25 25 25 25 25 25 25 25 25 25 25 25 25 25 25 25 25 25 25 25 25 25 25 25 25 25 25 25 25 25 25 25 25 25 25 25 25 
